11111111111
10001010011
10000000011
11100110011
10000000011
10100100011
10100100011
10111010011
10100000011
10111001011
10001001011
10111001011
10100011011
101X0100011
11111111111